+-+-+-+-+-+-+-+-+-+-+-+-+-+-+-+
| | |   | |     | |   |       |
+ + + + + + +-+ + + +-+-+ +-+-+
|     | | | |   | | |   | |   |
+ +-+ + + +-+ + + + + + + +-+ +
|   | |       |     | | | | | |
+ +-+ +-+-+ + + + +-+ +-+ + + +
|   | | | | | | |       |     |
+ + + + + +-+ + +-+ +-+-+-+ +-+
| | |     |   | | | | |   |   |
+ +-+-+-+ + +-+-+ + + +-+ + + +
|   | |   |   |   | |   |   | |
+ + + +-+-+ +-+-+ + +-+ +-+ +-+
| |   | | |   | |   |     |   |
+-+ +-+ + +-+ + +-+ +-+-+ + + +
|       | | | |   |   | |   | |
+-+-+ + + + + +-+ +-+ + + +-+-+
|   | |   |   | |   |     |   |
+-+ + + +-+ +-+ + + + + +-+ + +
| | | | | |       | | | |   | |
+ + + + + +-+-+ +-+ +-+ + +-+-+
|   | |   |   |   |   | |   | |
+-+ +-+-+ +-+ +-+-+ +-+-+-+ + +
|   |         | | |   |     | |
+-+ +-+-+ +-+ + + + + +-+-+ + +
| |         |     | | |   | | |
+ + +-+-+ +-+ +-+ +-+ + +-+ + +
| | | | | | |   |   |     |   |
+ + + + + + + +-+-+-+ +-+-+ +-+
|       |   |     |           |
+-+-+-+-+-+-+-+-+-+-+-+-+-+-+-+
